11;11
DDDDDDDDDDP
DDUUUUUUUDP
DDUUUUUUUDP
DDUUUUUUUDP
DDDDDDDDDDP
PPPPPPPPPPP
PDDDDDDDDDD
PDUUUUUUUDD
PDUUUUUUUDD
PDUUUUUUUDD
PDDDDDDDDDD